########
#     O#
# P    #
#      #
#  X   #
#      #
###########
   #   #  #
   #   #  #
   ########
