############
#        O #
#   P   X  #
#          #
############
