############
#      #   #
# # X      #
# ##X####X##
#     P#   #
###### X   #
    ## #####
    #  OOOO#
    #  #####
    #  #
    ####
